lsd
Budgee Jump - Captain Hook
Creatures - Alpha Portal
Billy Boy - Vertical Mode
Bulbo - FEATHERED SUN
Amniotic - Monolink
How Strange - FEATHERED SUN
Eyes Open - Gidge
Untitled (Late Sun) - Kerala Dust
Paper Trails - DARKSIDE
Kush High - Eighty4 Fly
When I Was Done Dying - Dan Deacon
Psychedelic Addit - Anuka
Maggot Brain - Funkadelic
2020 - Suuns
Pie IX - Suuns
No Quarter - Led Zepplin
The Gargon - Liquid Stranger
30 Past 7 - King Gizzard & and the Lizard Wizard
Hurdy Gurdy Man - Donovan
Marooned - Pink Floyd
Pigs (Three Different Ones) - Pink Floyd
Zodiac Shit - Flying Lotus
Dream, Ivory - Dream, Ivory
Turnstile Blues - Autolux
deSolate - Woodju
Crimson and Clover - Tommy James & The Shondells
Magoo - Country Joe & The Fish
One Way Trip To The Sun - Ditch
Cycle - Su Na
Music To Die To - HelloHeathen
Easter Bunny - Guillaume Roussel
Mask - Josh Pan
Future Waves - Uther Moads